###########################
#............#............#
#.####.#####.#.#####.####.#
#.........................#
#.####.#.#########.#.####.#
#......#.....#.....#......#
######.#####.#.#####.######
.....#.#...........#.#.....
######.#.####.####.#.######
#........#.......#........#
######.#.#########.#.######
.....#.#...........#.#.....
######.#.#########.#.######
#............#............#
#.####.#####.#.#####.####.#
#....#...............#....#
####.#.#.#########.#.#.####
#......#.....#.....#......#
#.##########.#.##########.#
#.........................#
###########################