###########################
#............#............#
#.####.#####.#.#####.####.#
#.........................#
#.####.#.#########.#.####.#
#......#.....#.....#......#
###.##.#####.#.#####.##.###
#......#...........#.#....#
###.##.#.####.####.#.##.###
#........#.......#........#
#.####.#.#########.#.####.#
#....#.#...........#.#....#
#.####.#.#########.#.####.#
#............#............#
#.####.#####.#.#####.####.#
#....#...............#....#
####.#.#.#########.#.#.####
#......#.....#.....#......#
#.##########.#.##########.#
#.........................#
###########################